  |!A!b|!A b| A b| A!b|
--|----|----|----|----|
!c|  0 |  1 |  0 |  0 |
--|----|----|----|----|
 c|  1 |  1 |  1 |  1 |
--|----|----|----|----|