  |!x!y|!x y| x y| x!y|
--|----|----|----|----|
!z|  1 |  1 |  0 |  1 |
--|----|----|----|----|
 z|  1 |  0 |  0 |  0 |
--|----|----|----|----|