  | !a |  a |
--|----|----|
!b|  1 |  0 |
--|----|----|
 b|  0 |  1 |
--|----|----|